20
15
0 0 0 0 0 0 0 0 0 0 0 0 0 0 0 0 0 0 0 0 
0 0 0 0 0 0 0 0 0 0 0 0 0 0 0 0 0 0 0 0 
0 0 0 0 0 0 0 0 0 0 0 0 0 0 0 0 0 0 0 0 
0 0 0 0 0 0 0 0 0 0 0 0 0 0 0 0 0 0 1 22 
5 2 0 0 0 0 0 0 0 0 0 0 0 0 0 0 0 0 1 22 
5 2 0 0 0 0 0 0 0 0 0 0 0 0 0 0 0 0 1 22 
5 2 0 0 0 0 0 0 0 0 0 0 23 24 25 0 0 0 1 22 
5 2 0 0 0 0 0 0 0 0 0 0 0 0 0 0 0 0 1 22 
5 2 0 0 0 0 0 0 0 0 0 0 0 0 9 0 0 23 24 22 
5 2 0 0 0 12 0 0 0 0 0 0 23 24 25 0 0 0 1 22 
5 2 0 0 0 0 0 11 0 0 0 0 0 0 0 9 0 0 1 22 
5 2 9 10 0 0 1 7 2 1 21 2 0 0 1 21 2 11 1 22 
22 21 21 21 21 21 21 5 21 21 22 21 21 21 21 22 21 21 21 22 
22 22 22 22 22 22 22 22 22 22 22 22 22 22 22 22 22 22 22 22 
0 0 0 0 0 0 0 0 0 0 0 0 0 0 0 0 0 0 0 0 
